1111111111111111111
100000000000000001
1000000000000000011
1000000000000000011111111
1000000000000000001111101
1000000000000000011111101
100000000000000001    111
111111111111111111