NO ./../textures/wall_n.xpm
SO ./../textures/wall_s.xpm
WE ./../textures/wall_w.xpm
EA ./../textures/wall_e.xpm
F 220,100,0
C 225,30,255



 1111111111111111111
 1000000000000000001
11000000000000000011
 1001000000000000011111111
 10000000011100000D000001111111
 10E000000D010000011111111
 10000000011100000001111
 100000000111111D1111111111
 10000000011111101111111111
 10000000011111101111111111
 100000000D00000011111111
 10000000011111111111111111
 10000000011111111111111111
 111111111111111111111111