NO ./../textures/wall_n.xpm
SO ./../textures/wall_s.xpm
WE ./../textures/wall_w.xpm
EA ./../textures/wall_e.xpm
F 150,100,5
C 10,1,20



 1111111111111111111
 1000010100000000001
1100001D100000000111
 1001000000000000011111111
 10000000011100000D000001111111
 100000000D010000011111111
 10000000011100000001111
 100000000111111D1111111111
 100000N0011111101111111111
 10000000011111101111111111
 100000000D00000011111111
 10000000011111111111111111
 1000000011111111111111111
 111111111111111111111111