NO ./path_to_the_north_texture
SO ./path_to_the_south_texture
WE ./path_to_the_west_texture
EA ./path_to_the_east_texture
F 220,100,0
C 225,30,0



1111111111111111111
1000000000000000001
1000000000000000011
100000000E000000011111111
1000000001110000011111011
1000000001 10000011111101
100000000111000011   1111
111111111111111111