111111111111111111
100000001000000001
100000001000000001
100000001000000001
100000001000000001
100000001000000001
111111111111111111