NO ./../textures/wall_n.xpm
SO ./../textures/wall_s.xpm
WE ./../textures/wall_w.xpm
EA ./../textures/wall_e.xpm
F 220,100,0
C 225,30,0


111111111111111111111111111111111111
100000001000000001000000000000000001
100000001000000001000000000000000001
10000000S000000001000000000000000001
100000001000000001111111111111111111
100000001000000001
111001111111111111
111101111111111111
100000001000000001
100000001000000001
100000001000000001
100000001000000001
100000001000000001
111100111111111111
100000001000000001
100000001000000001
111100111111111111
111100111111111111
100000001000000001
100000001000000001
100000001000000001
100000001000000001
100000001000000001
111100111111111111
100000001000000001
100000001000000001
111110011111111111
111110011111111111
100000001000000001
100000001000000001
100000001000000001
100000001000000001
100000001000000001
111110011111111111
100000001000000001
100000001000000001
111111001111111111
111111001111111111
100000001000000001
100000001000000001
100000001000000001
100000001000000001
100000001000000001
111111001111111111
111111001111111111
100000001000000001
100000001000000001
100000001000000001
100000001000000001
100000001000000001
111111100001111111
100000001000000001
100000001000000001
1111111000111111111
111111111111111111
100000001000000001
100000001000000001
100000001000000001
100000001000000001
100000001000000001
111111111111111111
100000001000000001
100000001000000001
111111111111111111
111111111111111111
100000001000000001
100000001000000001
100000001000000001
100000001000000001
100000001000000001
111111111111111111
100000001000000001
100000001000000001
111111111111111111
111111111111111111
100000001000000001
100000001000000001
100000001000000001
100000001000000001
100000001000000001
111111111111111111
111111111111111111
100000001000000001
100000001000000001
100000001000000001
100000001000000001
100000001000000001
111111111111111111
100000001000000001
100000001000000001
111111111111111111
111111111111111111
100000001000000001
100000001000000001
100000001000000001
100000001000000001
100000001000000001
111111111111111111
100000001000000001
100000001000000001
111111111111111111
111111111111111111
