NO ./../textures/wall_n.xpm
SO ./../textures/wall_s.xpm
WE ./../textures/wall_w.xpm
EA ./../textures/wall_e.xpm
F 220,100,0

C 225,30,0
        
 11111111111
 10000000001
 10000000001
 10000100001
 10000N00001
 10000000001
 10000000001
 10000000001
 11111111111